[
  {
    "type": "palette",
    "id": "bridge_palette",
    "terrain": {
      " ": "t_open_air",
      ".": "t_pavement",
      ":": "t_pavement_y",
      "]": "t_sidewalk",
      "X": "t_wall_r"
    }
  },
  {
    "type": "mapgen",
    "method": "json",
    "om_terrain": [ "bridge_ramp" ],
    "object": {
      "fill_ter": "t_open_air",
      "rows": [
        "    .......::.......    ",
        "    ................    ",
        "    .......::.......    ",
        "    .......::.......    ",
        "...........::...........",
        "..XXXX.XXXX.X...X.XXXX..",
        "..X..X.X..X.XX.XX.X..X..",
        "..XXX..XXXX.X.X.X.XXXX..",
        "..X..X.X..X.X...X.X.....",
        "........................",
        "...........]]...........",
        ".:::......]]]]......:::.",
        ".:::......]]]]......:::.",
        "...........]]...........",
        "........................",
        "........................",
        "........................",
        "........................",
        "........................",
        "........................",
        "    .......::.......    ",
        "    .......::.......    ",
        "    .......::.......    ",
        "    ................    "
      ],
      "palettes": [ "bridge_palette" ]
    }
  },
  {
    "type": "mapgen",
    "method": "json",
    "om_terrain": [ "bridgehead_ground" ],
    "object": {
      "fill_ter": "t_open_air",
      "rows": [
        "    .......::.......    ",
        "    ................    ",
        "    .......::.......    ",
        "    .......::.......    ",
        "...........::...........",
        "..X...X.XXXXX.XXXX......",
        "..X...X.X.....X..X......",
        "..XXXXX.XXXXX.XXXX......",
        "..X...X.X.....X..X......",
        "..X...X.XXXXX.X..X......",
        "...........]]...........",
        ".:::......]]]]......:::.",
        ".:::......]]]]......:::.",
        "...........]]...........",
        "........................",
        "........................",
        "........................",
        "........................",
        "........................",
        "........................",
        "    .......::.......    ",
        "    .......::.......    ",
        "    .......::.......    ",
        "    ................    "
      ],
      "palettes": [ "bridge_palette" ]
    }
  },
  {
    "type": "mapgen",
    "method": "json",
    "om_terrain": [ "bridgehead_ramp" ],
    "object": {
      "fill_ter": "t_open_air",
      "rows": [
        "    .......::.......    ",
        "    ................    ",
        "    .......::.......    ",
        "    .......::.......    ",
        "...........::...........",
        ".....XXXXXXXXXXXXX......",
        "....X............X......",
        "....X............X......",
        "....X............X......",
        "...........XXXXXXX......",
        "..........X.]]..........",
        ".:::.....X.]]]].....:::.",
        ".:::....X..]]]].....:::.",
        ".......X....]]..........",
        "......X.................",
        ".....X..................",
        "....XXXXXXXXXXXXX.......",
        "........................",
        "........................",
        "........................",
        "    .......::.......    ",
        "    .......::.......    ",
        "    .......::.......    ",
        "    ................    "
      ],
      "palettes": [ "bridge_palette" ]
    }
  }
]
