[
  {
    "type": "palette",
    "id": "railroad_bridge_ground_palette",
    "terrain": {
      "^": "t_railroad_rubble",
      "t": "t_railroad_tie",
      "-": "t_railroad_tie_h",
      "|": "t_railroad_tie_v",
      "/": "t_railroad_tie_d",
      "X": "t_railroad_track",
      "H": "t_railroad_track_h",
      "V": "t_railroad_track_v",
      "D": "t_railroad_track_d",
      "E": "t_railroad_track_d1",
      "F": "t_railroad_track_d2",
      "x": "t_railroad_track_on_tie",
      "h": "t_railroad_track_h_on_tie",
      "v": "t_railroad_track_v_on_tie",
      "d": "t_railroad_track_d_on_tie"
    }
  },
  {
    "type": "palette",
    "id": "railroad_bridge_ground_palette",
    "terrain": {
      ",": "t_region_soil",
      "s": "t_water_moving_sh",
      "~": "t_water_moving_dp",
      ".": "t_pavement",
      ":": "t_pavement_y",
      "_": "t_sidewalk",
      "=": "t_guardrail",
      "u": "t_ramp_up_low",
      "U": "t_ramp_up_high",
      "d": "t_ramp_down_high",
      "D": "t_ramp_down_low",
      "W": "t_sidewalk_ramp_down_high",
      ">": "t_sidewalk_ramp_down_low",
      "<": "t_sidewalk_ramp_up_high",
      "w": "t_sidewalk_ramp_up_low",
      "#": "t_concrete_wall"
    }
  },
  {
    "type": "palette",
    "id": "railroad_bridge_road_palette",
    "terrain": {
      " ": "t_open_air",
      ".": "t_pavement_hw_air",
      ":": "t_pavement_y_hw_air",
      "_": "t_sidewalk_hw_air",
      "=": "t_guardrail_hw_air",
      "U": "t_ramp_up_high",
      "d": "t_ramp_down_high",
      "D": "t_ramp_down_low",
      "W": "t_sidewalk_ramp_down_high",
      ">": "t_sidewalk_ramp_down_low",
      "<": "t_sidewalk_ramp_up_high",
      "w": "t_sidewalk_ramp_up_low",
      "#": "t_concrete_wall"
    }
  },
  {
    "type": "mapgen",
    "method": "json",
    "om_terrain": [ "railroad_bridge" ],
    "object": {
      "fill_ter": "t_water_moving_dp",
      "rows": [
        "~~~~~~~~s######s~~~~~~~~",
        "~~~~~~~~ss####ss~~~~~~~~",
        "~~~~~~~~~ss##ss~~~~~~~~~",
        "~~~~~~~~~~ssss~~~~~~~~~~",
        "~~~~~~~~~~~~~~~~~~~~~~~~",
        "~~~~~~~~~~~~~~~~~~~~~~~~",
        "~~~~~~~~~~~~~~~~~~~~~~~~",
        "~~~~~~~~~~~~~~~~~~~~~~~~",
        "~~~~~~~~~~~~~~~~~~~~~~~~",
        "~~~~~~~~~~~~~~~~~~~~~~~~",
        "~~~~~~~~~~~~~~~~~~~~~~~~",
        "~~~~~~~~~~~~~~~~~~~~~~~~",
        "~~~~~~~~~~~~~~~~~~~~~~~~",
        "~~~~~~~~~~~~~~~~~~~~~~~~",
        "~~~~~~~~~~~~~~~~~~~~~~~~",
        "~~~~~~~~~~~~~~~~~~~~~~~~",
        "~~~~~~~~~~~~~~~~~~~~~~~~",
        "~~~~~~~~~~~~~~~~~~~~~~~~",
        "~~~~~~~~~~~~~~~~~~~~~~~~",
        "~~~~~~~~~~~~~~~~~~~~~~~~",
        "~~~~~~~~~~ssss~~~~~~~~~~",
        "~~~~~~~~~ss##ss~~~~~~~~~",
        "~~~~~~~~ss####ss~~~~~~~~",
        "~~~~~~~~s######s~~~~~~~~"
      ],
      "palettes": [ "railroad_bridge_ground_palette" ]
    }
  },
  {
    "type": "mapgen",
    "method": "json",
    "om_terrain": [ "railroad_bridge_road" ],
    "object": {
      "fill_ter": "t_open_air",
      "rows": [
        "  =_................_=  ",
        "  =_.......::......._=  ",
        "  =_.......::......._=  ",
        "  =_.......::......._=  ",
        "  =_................_=  ",
        "  =_.......::......._=  ",
        "  =_.......::......._=  ",
        "  =_.......::......._=  ",
        "  =_................_=  ",
        "  =_.......::......._=  ",
        "  =_.......::......._=  ",
        "  =_.......::......._=  ",
        "  =_................_=  ",
        "  =_.......::......._=  ",
        "  =_.......::......._=  ",
        "  =_.......::......._=  ",
        "  =_................_=  ",
        "  =_.......::......._=  ",
        "  =_.......::......._=  ",
        "  =_.......::......._=  ",
        "  =_................_=  ",
        "  =_.......::......._=  ",
        "  =_.......::......._=  ",
        "  =_.......::......._=  "
      ],
      "palettes": [ "railroad_bridge_road_palette" ]
    }
  },
  {
    "type": "mapgen",
    "method": "json",
    "om_terrain": [ "railroad_bridgehead_ground" ],
    "object": {
      "fill_ter": "t_water_moving_dp",
      "rows": [
        ",,__................__,,",
        ",,__.......::.......__,,",
        ",,__.......::.......__,,",
        ",,__.......::.......__,,",
        "ss=_................_=ss",
        "ss=_.......::......._=ss",
        "ss=_.......::......._=ss",
        "ss=_.......::......._=ss",
        "ss=_................_=ss",
        "ss=_.......::......._=ss",
        "ss=_.......::......._=ss",
        "ss=_.......::......._=ss",
        "ss=_................_=ss",
        "ss=wuuuuuuuuuuuuuuuuw=ss",
        "ss=<UUUUUUUUUUUUUUUU<=ss",
        "ss####################ss",
        "ss####################ss",
        "ssssssssssssssssssssssss",
        "~~ssssssssssssssssssss~~",
        "~~~~~~~~~~~~~~~~~~~~~~~~",
        "~~~~~~~~~~ssss~~~~~~~~~~",
        "~~~~~~~~~ss##ss~~~~~~~~~",
        "~~~~~~~~ss####ss~~~~~~~~",
        "~~~~~~~~s######s~~~~~~~~"
      ],
      "palettes": [ "railroad_bridge_ground_palette" ]
    }
  },
  {
    "type": "mapgen",
    "method": "json",
    "om_terrain": [ "railroad_bridgehead_ramp" ],
    "object": {
      "fill_ter": "t_open_air",
      "rows": [
        "                        ",
        "                        ",
        "                        ",
        "                        ",
        "                        ",
        "                        ",
        "                        ",
        "                        ",
        "                        ",
        "                        ",
        "                        ",
        "                        ",
        "                        ",
        "  =>DDDDDDDDDDDDDDDD>=  ",
        "  =WddddddddddddddddW=  ",
        "  =_.......::......._=  ",
        "  =_................_=  ",
        "  =_.......::......._=  ",
        "  =_.......::......._=  ",
        "  =_.......::......._=  ",
        "  =_................_=  ",
        "  =_.......::......._=  ",
        "  =_.......::......._=  ",
        "  =_.......::......._=  "
      ],
      "palettes": [ "railroad_bridge_road_palette" ]
    }
  }
]
